################################################################################
#S                                                                  #          #
################################################################### # ######## #
#                                                           ####### # ##    ## #
# ######################################################### #       # ## ## ## #
# # #E                                                    # ####### # ## ## ## #
# # ##################################################### #         # ## #  ## #
# #                                                       ######### # ## ## ## #
# ####################################################### # #       # ## ## ## #
# #                                                         # ##### # ## ## ## #
# # ####################################################### # # ### # ## ## ## #
# # #        #########################                      # #     # ## ## ## #
# # # ######                         ######################## ##### # ## ## ## #
# # # ## ### ####################### # ##     ###     ##    ##    # # ## ## ## #
# # #  #     #                       #    ###     ###    ##    #### # ## ## ## #
# # ## ############################# # ############################ # ## ## ## #
# # ## #                        ###  #                            # # ## ## ## #
# # ## # ########### ############   ## ############################## ## ## ## #
# #    #           # #            ####                                #  ###   #
# ################ # ####### ######### ##############################   #### # #
#                # # #                                            # ########## #
######## ######### # ############################################## #          #
#                  #                                                  ### ######
################################################################################